40
40
20 20 20 20 20 20 20 20 20 20 20 20 20 20 20 20 20 20 20 20 20 20 20 20 20 20 20 20 20 20 20 20 20 20 20 20 20 20 20 20 
20 20 20 20 3 1 20 20 20 20 20 20 20 20 20 20 20 20 20 20 20 20 20 20 20 20 20 20 20 20 20 20 20 20 20 20 20 20 20 20 
20 20 2 1 1 2 1 1 20 20 2 1 2 20 20 20 20 20 20 20 20 1 1 1 1 20 20 20 20 20 20 1 1 1 1 1 1 20 20 20 
20 20 1 1 2 1 1 3 1 1 1 22 22 22 20 20 20 20 20 20 1 1 3 2 1 1 20 20 20 20 1 3 1 2 1 2 1 1 20 20 
20 20 1 1 3 1 1 1 1 3 22 22 22 22 20 20 20 20 20 1 2 1 3 3 1 1 1 22 22 1 1 3 1 1 1 3 1 1 20 20 
20 20 2 1 1 1 2 1 2 2 22 22 22 22 20 20 20 20 20 1 1 1 1 1 1 2 1 22 22 1 1 1 3 1 2 1 1 20 20 20 
20 20 20 3 1 20 20 20 20 2 22 22 22 20 20 20 20 20 1 1 3 3 1 20 20 1 1 22 22 22 1 1 2 1 1 1 20 20 20 20 
20 20 20 20 20 20 20 20 20 20 22 22 22 20 20 20 20 20 1 1 20 20 20 20 20 20 20 22 22 22 20 20 20 20 20 20 20 20 20 20 
20 20 20 20 20 20 20 20 20 20 22 22 22 20 20 20 20 20 1 1 20 20 20 20 20 20 20 22 22 22 20 20 20 20 20 20 20 20 20 20 
20 20 20 3 20 20 20 20 20 1 3 22 22 1 1 20 20 20 1 3 20 20 20 20 20 20 22 22 22 22 20 20 20 20 20 20 20 20 20 20 
20 20 20 1 1 1 1 20 20 1 1 22 22 22 1 20 20 1 1 1 1 20 20 20 20 22 22 22 22 22 20 20 20 20 1 1 20 20 20 20 
20 20 1 1 3 1 1 20 20 1 22 22 22 22 2 20 20 1 2 1 1 1 20 3 20 22 22 22 22 20 20 20 20 1 3 1 1 20 20 20 
20 20 1 3 1 3 1 1 1 1 22 22 22 22 1 1 1 1 1 2 1 2 20 20 20 22 22 20 20 20 20 20 20 1 2 1 1 3 20 20 
20 20 1 1 3 1 1 20 20 1 22 22 22 1 3 1 3 1 3 1 1 1 20 20 20 3 1 20 20 1 1 3 1 1 2 1 1 1 20 20 
20 20 20 1 1 1 1 20 20 3 1 22 22 2 1 20 20 2 1 1 1 20 20 20 20 1 2 1 20 1 20 20 20 1 1 1 1 20 20 20 
20 20 20 20 1 20 20 20 20 20 20 20 20 20 2 20 20 20 20 20 20 20 20 20 20 20 20 1 20 2 20 20 20 20 20 1 2 20 20 20 
20 20 20 20 1 20 20 20 20 20 20 20 20 20 1 20 20 20 20 20 20 20 20 20 20 20 20 1 20 1 20 20 20 20 20 1 1 20 20 20 
20 20 20 20 21 20 20 20 20 20 20 1 1 2 1 20 20 1 1 1 1 1 1 20 20 2 3 1 20 1 20 20 20 20 20 3 1 20 20 20 
20 20 2 3 1 20 20 20 20 20 1 3 20 20 20 20 20 1 1 3 1 2 1 20 20 21 20 20 20 2 1 20 20 20 20 1 1 20 20 20 
20 20 1 20 20 20 20 20 20 1 1 20 20 20 20 20 20 1 2 1 1 3 1 20 20 3 1 2 20 20 1 20 20 20 20 20 1 20 20 20 
20 20 3 2 1 2 1 3 1 2 1 20 20 20 1 1 21 1 1 2 1 2 1 20 20 1 20 1 3 1 1 20 20 20 20 20 2 20 20 20 
20 20 20 20 20 20 20 20 20 1 1 1 20 20 20 20 20 1 3 2 1 1 3 20 20 2 20 20 20 20 20 20 20 20 20 20 1 20 20 20 
20 20 20 20 20 20 20 20 20 20 3 1 20 20 20 20 20 3 1 1 1 1 1 20 20 1 1 3 1 3 1 20 20 20 20 20 3 20 20 20 
20 20 20 20 20 20 20 20 20 20 20 1 20 20 20 20 20 20 20 20 20 20 20 20 20 20 20 20 20 20 1 20 20 20 20 20 1 20 20 20 
20 20 20 20 20 20 20 20 20 20 20 21 20 20 20 20 20 20 20 1 1 20 20 20 20 20 20 20 20 20 1 20 20 20 20 20 1 20 20 20 
20 20 20 20 20 20 20 20 20 20 20 1 22 20 20 20 20 20 1 1 1 20 20 20 20 20 20 3 1 1 1 20 20 20 20 20 1 3 1 20 
20 20 20 1 3 20 20 20 20 1 2 1 22 22 20 20 20 20 1 2 1 3 20 20 20 20 1 1 2 1 1 20 20 20 20 20 3 1 3 20 
20 20 1 1 1 2 1 20 1 1 3 22 22 22 22 20 20 20 1 3 1 2 20 20 20 2 1 3 1 1 1 3 1 3 20 20 20 3 20 20 
20 20 1 2 1 2 3 20 1 1 22 22 22 22 1 20 20 1 2 1 3 2 20 20 20 1 1 2 1 3 1 1 2 1 2 20 20 20 20 20 
20 20 20 1 1 1 1 20 20 20 22 22 22 3 1 1 1 3 1 1 1 1 20 20 20 3 1 1 2 1 20 20 20 3 1 22 22 22 22 20 
20 20 20 3 1 2 1 20 20 20 20 22 22 20 20 20 20 1 20 20 20 1 1 1 1 1 3 1 1 20 20 20 20 1 22 22 22 22 22 20 
20 20 20 2 1 20 20 20 20 20 20 20 20 20 20 20 20 20 20 20 20 20 20 20 20 20 20 20 20 20 20 20 20 20 20 22 22 22 22 20 
20 20 20 1 1 20 20 20 20 20 20 20 20 20 20 20 20 1 20 20 20 1 20 20 20 20 20 20 20 20 20 20 20 20 20 22 22 22 22 20 
20 20 20 1 1 20 20 20 20 20 20 20 20 20 1 1 1 3 20 20 20 1 1 1 1 3 1 20 20 20 20 20 20 20 22 22 22 22 22 20 
20 20 1 3 1 20 20 20 20 20 20 3 1 1 2 20 20 20 20 20 20 1 3 1 1 1 2 1 20 20 20 20 20 20 22 22 22 22 22 20 
20 20 2 1 1 20 20 20 20 20 20 2 20 20 20 20 20 20 20 20 1 2 1 3 1 3 1 3 1 20 20 20 20 20 22 22 22 22 22 20 
20 20 1 1 2 1 20 20 20 20 20 21 20 20 20 20 20 20 20 20 1 1 1 1 2 1 2 1 1 20 20 20 20 20 20 22 22 22 20 20 
20 20 20 1 3 1 1 1 1 1 2 1 20 20 20 20 20 20 20 20 20 3 1 1 3 1 2 1 20 20 20 20 20 20 20 1 1 1 20 20 
20 20 20 20 1 2 20 20 20 20 20 20 20 20 20 20 20 20 20 20 20 20 20 20 20 1 1 20 20 20 20 20 20 20 20 20 1 20 20 20 
20 20 20 20 20 20 20 20 20 20 20 20 20 20 20 20 20 20 20 20 20 20 20 20 20 20 20 20 20 20 20 20 20 20 20 20 20 20 20 20 
